NO ./imgs/bluestone.xpm
SO ./imgs/colorstone.xpm
WE ./imgs/greystone.xpm
EA ./imgs/redbrick.xpm


F 255,255,255
C 225,30,0

11111111111111111111
10000100000000000001
10000000000000000001
101000N0000100000001
10000000000000000001
10000100000000000001
11111111111111111111