NO ./imgs/greystone.xpm
SO ./imgs/colorstone.xpm
WE ./imgs/bluestone.xpm
EA ./imgs/redbrick.xpm


F 0,0,0
C 255,0,0

11111111111111111
10000000000000001
10000000000000001
10000000000000001
10000000000000001
10000000000000001
1000000000000W001
11111111111111111