NO ./imgs/greystone.xpm
SO ./imgs/colorstone.xpm
WE ./imgs/bluestone.xpm
EA ./imgs/redbrick.xpm

F 119,120,118
C 171,212,255

1111111
1001001
101E101
1001001
1111111