NO   Cub3d.xpm
SO Cub3d.xpm
WE Cub3d.xpm
EA Cub3d.xpm


F 255,100,100
C 225,30,200




101111
10a101
101001
1100N1
111111
