NO ./imgs/char.xpm
SO ./imgs/char.xpm
WE ./imgs/char.xpm
EA ./imgs/char.xpm


F 255,255,255
C 225,30,0


11111111111111111111111
10000000000000000000001
1000000000000N000000001
10000000000000000000001
11111111111111111111111