NO ./imgs/char.xpm
SO ./imgs/char.xpm
WE ./imgs/char.xpm
EA ./imgs/char.xpm


F 255,255,255
C 225,30,0

1111111111
1010000101
1110000111
1000000001
1000N00001
1000000001
1110000111
1010000101
1111111111