NO ./imgs/barrel.xpm
SO ./imgs/barrel.xpm
WE ./imgs/barrel.xpm
EA ./imgs/barrel.xpm


F 255,255,255
C 225,30,0


        1111111111111111111111111
        1000000000110000000000001
        1011000001110000000000001
        100100000000000000000011
11111111101100000111000000000001
100000000011000001110111111111111
11110111111111011100000010001
1111111111111111111111111111
                             
11111111111111111111111111111
11000000110101011100000010001
10000000000000001100000010001
10000000000000001101N10010001
110000011101010111110111100111
11110111 1110101 10111110001
11111111 1111111 111111111111