NO ./imgs/greystone.xpm
SO ./imgs/colorstone.xpm
WE ./imgs/bluestone.xpm
EA ./imgs/redbrick.xpm


F 255,255,255
C 225,30,0

11111111111111111
10000000000000001
10000000000000001
10000000000000001
10000S00000000001
10000001000000001
10000000000000001
11111111111111111