NO ./imgs/barrl.xpm
SO ./path_to_the_south_texture
WE ./path_to_the_west_texture
EA ./path_to_the_east_texture


F 255,255,255
C 225,30,0


11111111111
10000000001
10000000001
1N000000001
111111111