NO ./imgs/greystone.xpm
SO ./imgs/colorstone.xpm
WE ./imgs/bluestone.xpm
EA ./imgs/redbrick.xpm

F 119,120,118
C 171,212,255

11111111111
10000W00001
10000000001
11111111111