NO ./path_to_the_north_texture
SO ./path_to_the_south_texture
WE ./path_to_the_west_texture
EA ./path_to_the_east_texture


F 255,255,255
C 225,30,0


11111111111111
10001111111001
10001111111001
10N00000000001
1111