NO ./imgs/char.xpm
SO ./imgs/char.xpm
WE ./imgs/char.xpm
EA ./imgs/char.xpm


F 255,255,255
C 225,30,0


1111
1001
10N1
1001
1111